111111111111
100100000001
100000000001
100P00001001
1000C0000001
100000000111
10000010EC01
100000000001
101000010C01
100000000001
111111111111