1111111111111111
10000000P0000001
11110000000E0001
1111111111111111