1111111111111111111111111
11C0000000111111100011111
1110010000011E00011100111
1111111111111111111111111