11111111111111111111
111110000P000000111111
111000E00000C0001111
11111111111111111111