11111111111111
1000000C000001
1100000000P001
10000P00000001
1111E0000C0001
11111111111111